  ______  __  .__   __.  _______ .___  ___.      ___         .______        ______     ______   .___  ___.
 /      ||  | |  \ |  | |   ____||   \/   |     /   \        |   _  \      /  __  \   /  __  \  |   \/   |
|  ,----'|  | |   \|  | |  |__   |  \  /  |    /  ^  \       |  |_)  |    |  |  |  | |  |  |  | |  \  /  |
|  |     |  | |  . `  | |   __|  |  |\/|  |   /  /_\  \      |      /     |  |  |  | |  |  |  | |  |\/|  |
|  `----.|  | |  |\   | |  |____ |  |  |  |  /  _____  \     |  |\  \----.|  `--'  | |  `--'  | |  |  |  |
 \______||__| |__| \__| |_______||__|  |__| /__/     \__\    | _| `._____| \______/   \______/  |__|  |__|

Powered by Spring Boot ${spring-boot.version}
